1011110010011010101010101010100010101100100110001110100110001110
1101010100111010111010011100010111010101010100111010011000111100
0101001111001001101001100101010101010101010110011110100110100100
0001110000110110101111000101001101000011011001011001011010110110
0101001111001001100001100011110000111100100101000101100110101100
0101110100110110001110101100001111000011011001010011001011100101
0101001110101000111010010010111000111100110101011001101010100100
0011101011000011110000111100100110100110001101100001110011010101
1011101000101010010010010110010110011010101011000111010100110100
1001101011001011011000111100010101011011110000111100001111000101
0101100100101010101010100100010100111100010110010110100101100101
0101010110011010110010110110010110010110000101101001001011000111
0101010100111100001110101100010101011001011011010011110000111100
0101011110010110100111000101010101010011110001011001011010010100
0001110001011001011001010101001101101001011000110110100101100101
0111001100100110101101100011101010100010101010101010011010110110
